###########################
#A         #             #
# ######### # #########  #
#   #     # #     #     #
# # # ### # ### # # #####
# # #     #     # #     #
# # ####### ### # # #####
# #         #         B #
### ########### #########
#   #         #         #
# ########### ####### ###
#             #         #
###########################
